000000000000000
000000000000000
000000000000000
000100000200000
000210000210000
010200000200000
000200000200300
000200000000000
222200000000000
000000000000000
000000000300000
000000000000000
000000000000000
000000000200000
000000000200000
000000333333000
000000000000000
000000000000000
000000000000000
000000000000000
000000000000000
000000000000000
000000000000000
000000000000000
000000000000000