000000000000
000000000000
000000000000
000000000000
000000000000
100000000100
200000000220
000000000000
000000000000
000000000000
000000000000
010000000000
220000020000
000010110000
000022220000
000000000000
000000000000
000000000000
000000000000
000000000000