000000000000000
000000000000000
000000000000000
000100000200000
000210000210000
010200000200000
000200000230000
000200000000000
333300000000000
000000000000000
000000000000000
000000000000000
000000000000000
000000000200000
000000000200000
000000033333000
000000000000000
000000000000000
000000000000000
000000000000000
000000000000000
000000000000000
000000000000000
000000000000000
000000000000000