000000000000
000000000000
000000000000
000000020000
000210021000
010200020000
000200020000
000200000000
022200000000
000000020000
000000020000
000000222000
000000000001
000000000000
000000000000
000000000000
000000000000
000000000000
000000000000
000000000000