000000000000
000000000000
000000000000
000000000000
000000000000
010000000000
220000000000
010000000000
000000000000
200000000000
000000000000
010000000000
220000020000
000010010000
000022220000
000000000000
000000000000
000000000000
000000000000
000000000000