000000000000000
000000000000000
000000000000000
000000000000000
001000000000000
022220000000000
000000000000000
000000000000000
000000000010000
000000002222000
000001000000000
002222000000000
000000000000000
000000000000000
000000000001000
000000000222220
000000000000000
000000000000000
000000000000000
000000000000000
000000000000000
000000000000000
000000000000000
000000000000000
000000000000000