000000000000
000000000000
010000000000
000000010000
000000333000
000220000000
000000000000
200400000220
000400000000
000000000000
000000000000
000000000000
000000000000
000000000000
000000000000
000000000000
000000000000
000000000000
000000000000
000000000000