000000000000
000000000000
000000000000
000000000000
000000000000
010000030000
220000030000
000000004000
000000000000
200000000000
000000000000
010000000000
220000000000
000010010000
000022222200
000000000000
000000000000
000000000000
000000000000
000000000000