000000000000000
000000000000000
000000000000020
000000000100020
000000225200050
000000000000020
000000000000020
000010000000050
000252000000050
000000000000020
010000000000020
252200000000050
000000000000050
000000000000000
000000000000000
000000000000000
000000000000000
000000000000000
000000000000000
000000000000000
000000000000000
000000000000000
000000000000000
000000000000000
000000000000000