000000000000000
000000000000000
000000000000000
000100000200000
000210000210000
010200000200000
000200002222000
000200000000000
002222000000000
000000000000000
000000000000000
000000000000000
000000000000000
000000000000000
000000000000000
000000000000000
000000000000000
000000000000000
000000000000000
000000000000000
000000000000000
000000000000000
000000000000000
000000000000000
000000000000000