000000000000000
000000000000000
000000000000000
222000000000222
222000000000222
222000000000222
000000000000000
000000000000000
000000000000000
000000000000000
000020222020000
000120000021000
002220000022200
000020000020000
000020000020000
000020000020000
000000000000000
000000000000000
000000000000000
000000000000000
000000000000000
000000000000000
000000000000000
000000000000000
000000000000000