000000000000000
000000000000000
000000000000000
000000000000000
000000010000000
000000020000000
000000202000000
000000000000000
000000000000000
000000000000000
000020000020000
000120000021000
002220000022200
000020000020000
000020000020000
000020000020000
000000000000000
000000000000000
000000000000000
000000000000000
000000000000000
000000000000000
000000000000000
000000000000000
000000000000000