000000000000
000000000000
010000000000
000000010100
000000222000
010220000200
000000000000
200000000220
000000000000
000000000000
000000000000
000000000000
000000000000
000000000000
000000000000
000000000000
000000000000
000000000000
000000000000
000000000000