000000000000000
000000000000000
000000000000000
000010000020000
000020000021000
000020000020000
000020000020000
000000000020000
000000000001000
000000000000000
000020000002220
001020000002000
002250000002000
000050000000000
000000000000000
000000000000000
000000000000000
000000000000000
000000000000000
000000000000000
000000000000000
000000000000000
000000000000000
000000000000000
000000000000000