000000000000
000000000000
010000000000
000000010000
000000040001
000220040000
000000040000
200000000220
000000000000
000400000000
000400000000
000000000000
000000000000
000000000000
000000000000
000000000000
000000000000
000000000000
000000000000
000000000000