000000000000000
000000000000000
000000000001000
000000000002000
000000010002000
000000020002000
000000050002001
000000020000000
000000020000000
000401020000000
000402220005522
000400000002000
000000000002000
000000000000000
000000000000000
000000000000000
000000000000000
000000000000000
000000000000000
000000000000000
000000000000000
000000000000000
000000000000000
000000000000000
000000000000000